Ss, Gg, Hh, Gg, Hh, Gg^Fet, Gg, Gg, Gg, Gg^Fet, Gg, Gg, Rra, Rra, Gg, Gg, Gg, Gg, Gg, Gg
Ss, Ss^Ewf, Hh, Ss^Ewf, Ss^Ewf, Gg, Rd^Vwm, Gg^Fet, Rd^Wm, Gg, Rd^Vwm, Gs, Rd^Wm, Gg, Gg^Eff, Gg^Eff, Gg^Eff, Gg^Fet, Gg, Gg
Hh, Hh^Vdt, Hh, Ss, Ss^Ewf, Gg, Rp, Gg, Rp, Gg, Rp, Gg^Fet, Rp, Gg, Rb^Gvs, Rb^Gvs, Rb^Gvs, Gs^Eff, Gg^Eff, Gg
Hh, Hh, Ss, Hh, Hh, Hh, Gg, Rp, Gg^Fet, Rd, Gg^Eff, Rd, Rb^Gvs, Rb^Gvs, Re^Gvs, Rb^Gvs, Re^Gvs, Rb^Gvs, Rb^Gvs, Gg^Eff
Gg, Ss^Ewl, Hh, Hh, Ss, Hh, Hh, Rd, Rp^Eff, Gg^Eff, Rb^Gvs, Rb^Gvs, Re^Gvs, Rb^Gvs, Rb^Gvs, Rb^Gvs, Rb^Gvs, Rb^Gvs, Gs^Eff, Gg^Eff
Gg, Ss, Ss, Sm^Ewl, Ss, Ss, Ss^Ewl, Gg, Rp, Gs^Eff, Gg^Eff, Rb^Gvs, Rb^Gvs, Rb^Gvs, Rb^Gvs, Rb^Gvs, Gg^Eff, Gg^Eff, Gg^Fet, Gg
Md, Md, Md, Md, Md, Md, Md, Gg, Rra, Gg^Fet, Gg, Gg^Eff, Gg^Eff, Rb^Gvs, Md, Md, Md, Md, Md, Md
Md, Md, Md, Md, Md, Md, Ss, Gg, Rra, Gg^Vl, Gg^Fet, Gg^Vl, Gs, Gg, Ds, Dd^Vc, Ds, Dd, Ds, Md
Md, Md, Dd, Md, Ds, Md, Ds, Gg, Rra, Gg^Esd, Ds, Ds, Dd, Ds, Ss, Ds, Wog, Wo, Ww, Ds
Ds, Ds, Ww, Ds, Ww^Vm, Ds, Wwg, Ds, Ds^Bsb|, Ds, Wo, Ww^Ewf, Wo, Wo^Ewl, Wog, Wwg^Ewf, Wo, Wog, Ww^Vm, Wo
Wo, Wo, Ww, Wwg, Ww, Wog, Wog, Wo, Wo^Bsb|, Wo, Wog^Ewl, Wo, Hh, Wo, Md, Wo, Md, Md, Md, Wo
Wot, Wo, Md, Md, Md, Md, Hh, Wwg, Ww^Bsb|, Wo, Ww^Ewl, Ww^Ewf, Hhd, Md, Md, Md, Md, Md, Md, Md
Md, Md, Md, Md, Md, Md, Hhd, Hh, Rp, Wwg^Ewf, Hhd, Hhd, Hh, Hhd, Md, Md, Hh, Md, Md, Md
Md, Md, Hh, Hh, Hh, Md, Md, Hhd, Md, Rp, Rp, Hhd, Hh, Hh, Hh, Hh, Md, Md, Hh, Md
Md, Md, Md, Hh, Hh^Vl, Md, Md, Md, Md, Md, Md, Rp, Hhd, Hh, Md, Md, Md, Md, Hh, Md
Md, Md, Md, Hh, Hh, Md, Md, Md, Md, Md, Md, Rp, Md, Hhd, Md, Md, Md, Md, Md, Md
Md, Md, Md, Md, Md, Md, Md, Hh, Hhd, Md, Md, Rp, Md, Md, Md, Md, Md, Md, Md, Md
Md, Md, Hh, Md, Md, Md, Md, Hh, Md, Hh, Hh, Rp, Rp, Hhd, Md, Md, Md, Md, Md, Md
Md, Md, Md, Hh, Md, Md, Md, Hhd, Md, Md, Md, Hh, Rp, Rp^Vud, Md, Md, Md, Hh, Md, Md
Md, Md, Md, Hh, Md, Md, Md, Hhd, Hh, Md, Hh, Md, Rp, Md, Md, Md, Md, Md, Md, Md
Md, Md, Md, Md, Md, Md, Md, Md, Hhd, Hh, Md, Hhd, Md, Md, Md, Md, Md, Md, Md, Md
Md, Md, Md, Md, Md, Md, Hhd, Hhd, Md, Md, Md, Rp, Rp, Md, Hh, Hh, Hh, Md, Md, Md
Md, Md, Md, Md, Md, Md, Md, Md, Md, Md, Md, Md, Md, Rp, Rp, Hh, Hh, Md, Md, Md
Md, Md, Md, Md, Md, Md, Md, Md, Md, Md, Md, Md, Md, Md, Rp, Md, Md, Md, Md, Md
Gg, Gg, Gg, Gg, Gg, Gg, Gg, Gg, Gg, Gg, Gg, Gg, Gg, Gg, Rp, Gg, Gg, Gg, Gg, Gg
Gg, Gg, Gg, Gg, Gg, Gg, Gg, Gg, Gg, Gg, Gg, Gg, Gg, Gg, Rp, Gg, Gg, Gg, Gg, Gg
Gg, Gg, Gg, Gg, Gg, Gg, Gg, Gg, Gg, Gg, Gg, Gg, Gg, Gg, Rp, Gg, Gg, Gg, Gg, Gg
Gg, Gg, Gg, Gg, Gg, Gg, Gg, Gg, Gg, Gg, Gg, Gg, Rp, Rp, Gg, Gg, Gg, Gg, Gg, Gg
Gg, Gg, Gg, Gg, Gg, Gg, Gg, Gg, Gg, Gg, Gg, Gg, Gg, Gg, Gg, Gg, Gg, Gg, Gg, Gg
Gg, Gg, Gg, Gg, Gg, Gg, Gg, Gg, Gg, Gg, Gg, Gg, Gg, Gg, Gg, Gg, Gg, Gg, Gg, Gg
Gg, Gg, Gg, Gg, Gg, Gg, Gg, Gg, Gg, Gg, Gg, Gg, Gg, Gg, Gg, Gg, Gg, Gg, Gg, Gg
Gg, Gg, Gg, Gg, Gg, Gg, Gg, Gg, Gg, Gg, Gg, Gg, Gg, Gg, Gg, Gg, Gg, Gg, Gg, Gg
Gg, Gg, Gg, Gg, Gg, Gg, Gg, Gg, Gg, Gg, Gg, Gg, Gg, Gg, Gg, Gg, Gg, Gg, Gg, Gg
Gg, Gg, Gg, Gg, Gg, Gg, Gg, Gg, Gg, Gg, Gg, Gg, Gg, Gg, Gg, Gg, Gg, Gg, Gg, Gg
Gg, Gg, Gg, Gg, Gg, Gg, Gg, Gg, Gg, Gg, Gg, Gg, Gg, Gg, Gg, Gg, Gg, Gg, Gg, Gg
Gg, Gg, Gg, Gg, Gg, Gg, Gg, Gg, Gg, Gg, Gg, Gg, Gg, Gg, Gg, Gg, Gg, Gg, Gg, Gg
Gg, Gg, Gg, Gg, Gg, Gg, Gg, Gg, Gg, Gg, Gg, Gg, Gg, Gg, Gg, Gg, Gg, Gg, Gg, Gg
Gg, Gg, Gg, Gg, Gg, Gg, Gg, Gg, Gg, Gg, Gg, Gg, Gg, Gg, Gg, Gg, Gg, Gg, Gg, Gg
Gg, Gg, Gg, Gg, Gg, Gg, Gg, Gg, Gg, Gg, Gg, Gg, Gg, Gg, Gg, Gg, Gg, Gg, Gg, Gg
Gg, Gg, Gg, Gg, Gg, Gg, Gg, Gg, Gg, Gg, Gg, Gg, Gg, Gg, Gg, Gg, Gg, Gg, Gg, Gg
Gg, Gg, Gg, Gg, Gg, Gg, Gg, Gg, Gg, Gg, Gg, Gg, Gg, Gg, Gg, Gg, Gg, Gg, Gg, Gg
Gg, Gg, Gg, Gg, Gg, Gg, Gg, Gg, Gg, Gg, Gg, Gg, Gg, Gg, Gg, Gg, Gg, Gg, Gg, Gg
Gg, Gg, Gg, Gg, Gg, Gg, Gg, Gg, Gg, Gg, Gg, Gg, Gg, Gg, Gg, Gg, Gg, Gg, Gg, Gg
Gg, Gg, Gg, Gg, Gg, Gg, Gg, Gg, Gg, Gg, Gg, Gg, Gg, Gg, Gg, Gg, Gg, Gg, Gg, Gg
