Xu, Uu, Uu, Uue, Rb, Uu, Xu, Uue, Xu, Uu, Uhe, Uu, Uue^Es, Uh, Uh, Uue, Xu, Xu, Md^Xm, Ms^Xm, Ms^Xm, Ms^Xm, Ms^Xm, Ms^Xm, Ms^Xm, Ms^Xm, Hhd, Ms^Xm, Md, Md, Md, Md, Mm, Ms^Xm, Ms^Xm
Uh, Xu, Uhe, Xu, Uh, Uue^Vu, Rb, Uue^Es, Uue^Es, Xu, Xu, Uu^Es, Uhe, Uu^Es, Xu, Uhe, Uhe, Xu, Md^Xm, Md, Md^Xm, Hhd, Ms^Xm, Md, Md, Ms, Md, Md, Md, Md, Mm^Vl, Hhd^Fdw, Mm, Mm, Mm
Uhe, Uh, Xu, Xu, Re^Edb, Rb, Ce, Rb, Re, Gll, Re, Uue, Uue, Xu, Re^Es, Rb^Vu, Xu, Xu, Md^Xm, Ms^Xm, Ms, Md, Ms, Ms, Md, Md, Md, Md, Hhd^Em, Hhd^Fdf, Hhd^Fdw, Hhd^Fdw, Hhd^Fdw, Hhd^Fdf, Mm
Xue, Uue^Es, Uue^Es, Re, Gd^Es, Cer, 1 Ker, Cer^Es, Rb, Re, Re, Gd, Gd^Edb, Gll, Gll, Uue, Xu, Ms^Xm, Ms, Md, Ms, Md, Md, Md, Hhd^Fdf, Md, Hhd^Fdw, Hh^Fmf, Gd^Fmf, Hhd^Fmf, Rb^Fdw, Gd^Fmf, Gll^Fdw, Gg^Fmf, Gll^Fmf
Uh, Xue, Xue, Gll, Re, Re^Es, Cer^Es, Cer^Es, Gll, Rb, Re, Gll, Re, Gd, Gll, Gd, Gd, Md, Md, Gll^Fdf, Md, Hhd, Hhd^Fmf, Hhd^Vl, Hhd^Em, Hhd^Fmf, Hhd^Fdw, Gd^Fdw, Rb^Fmw, Gll^Fdw, Hhd^Fp, Rb^Fdw, Gd^Fdf, Re^Fdw, Gg^Fmf
Uh, Uue, Uh^Vu, Uue, Gd, Gd, Rb, Gd, Rd, Rb, Gll, Re, Gll, Re, Gll, Rb, Gll^Fdw, Hhd, Hhd^Fmf, Hhd, Hhd^Fmf, Hhd^Fdw, Hhd^Fdw, Hhd^Fdw, Gll^Fmf, Hhd^Fdf, Gd^Fmw, Re^Fdw, Gll^Fdw, Hhd^Fmf, Hhd^Fdw, Gll^Fdw, Hhd^Fdw, Rb^Fdw, Gll^Fmf
Uu, Uue, Uue, Gll, Gd, Gd, Rb, Re, Gll, Re, Re, Re, Rb, Gd, Gll^Fdw, Gll, Gll^Fdw, Hhd^Fdw, Rb^Fmw, Re^Fdw, Rb^Fdw, Gll^Fmf, Rb^Fdw, Gll^Fdf, Hhd^Fdw, Gll^Fdf, Gd^Fdw, Gll^Fdf, Rb^Fdw, Gll^Fdf, Gg^Fmf, Gd^Fdw, Rb^Fdw, Rb^Fdw, Gll
Xu, Uue, Gll^Es, Xu, Gll, Re, Gll, Rb, Gll, Re, Gll, Re, Rb, Gll, Re^Fdw, Rb^Fdw, Gd^Fmf, Re^Fdw, Rb^Fdw, Gd^Fdw, Hhd^Fdw, Gd^Fmw, Rb^Fdw, Gd^Fdw, Gd^Fdw, Gd^Fdf, Hhd^Fdw, Gll^Fmf, Gll^Fmf, Rb^Fmf, Gll^Fdw, Re^Fdw, Gll^Fmf, Hhd^Fdw, Gg^Fmf
Ms^Xm, Gll^Es, Hhd^Es, Gd^Es, Hhd, Gll, Rb, Re, Rb, Re, Gd, Gll, Rb^Vhr, Rb, Gll, Re^Fdw, Gd, Gll^Fdw, Gll^Fmf, Gll^Fdf, Gs^Fdw, Gd^Fdw, Hhd^Fdw, Gd^Fmf, Re^Fdf, Re^Fdw, Gd^Fdw, Hhd^Fdf, Gd^Fdw, Gll^Fdf, Rb^Fdw, Gll^Fmf, Rb^Fmf, Gd^Fdf, Gd
Mm, Mm, Mm, Hhd, Hhd, Hhd, Gd, Re, Gd, Re^Edb, Rb, Hhd, Rb, Gd, Rb, Rb, Gll^Fdw, Gll, Gd, Gll^Fdf, Re^Fdw, Gll^Fmf, Hhd^Fdw, Gll^Fmf, Gll^Fdf, Gd^Fmf, Gd^Fmw, Hhd^Fdw, Gll^Fdf, Re^Fdw, Gd^Fmf, Gll^Edt, Gd^Fdw, Rb^Fdw, Re
Mm, Mm, Mm, Hhd, Gd, Rb, Gll, Hhd, Gd, Re, Re, Rb, Gd, Gll, Re, Gd, Gll, Gs^Fmf, Gll^Fdf, Gd^Fdw, Rb^Fdw, Gll^Fdw, Gll^Fmf, Gll^Fmf, Rb^Fmf, Gd^Fmw, Gd^Fdw, Hhd^Fdw, Hhd^Fdf, Hhd^Fdw, Gll^Fdw, Gll^Fmf, Re^Fdw, Re^Fdw, Re
Ms^Xm, Ms^Xm, Hhd, Hhd, Hhd, Gll, Re, Gd, Gd, Gd, Re, Gd, Gll^Fdw, Rb, Rb, Re, Re, Gll, Gd, Gd^Fmw, Gd^Fmf, Hhd^Fdw, Rb^Fdw, Rb^Fdw, Gd^Vc, Gs^Fdw, Re^Fmf, Rb^Fdw, Gd^Fdw, Gs^Fdf, Rb^Fdw, Gd^Fdw, Rb^Fdw, Gll^Fdw, Rb
Mm, Mm, Hhd, Hhd, Hhd, Gd, Gd, Hhd, Gd, Rb, Rb, Gd, Gd, Gd, Gll, Gd, Hhd, Re^Fmf, Gd, Gd, Gll^Em, Gd^Fmf, Gd^Fdw, Gll^Fmf, Gll^Fmf, Re^Fdw, Rb^Fdw, Re^Fdw, Gd^Fdw, Rb^Fmf, Re^Fdf, Gd^Edt, Rb^Fdw, Gll^Fmf, Re
Mm, Mm, Mm, Hhd, Gd, Gd, Hhd, Hhd, Gd, Rb, Gd, Gll, Gd^Fdw, Gd, Gd, Hhd, Gll, Gd, Rb, Gll, Gs^Fdw, Gd^Fmf, Re^Fdw, Rb^Fdw, Gll^Fdw, Re^Fdw, Rb^Fdw, Gll^Fmf, Hhd^Fmf, Gll^Fmf, Gll^Fdw, Rb^Fdw, Gd^Fdw, Rb^Em, Gll
Hhd, Hhd, Gd, Hhd^Vct, Gll^Edb, Hhd, Hhd, Hhd, Gll, Gd, Hhd, Gd, Gd, Gll, Re, Gd, Rb, Gll, Gll, Gd, Gd, Gll^Fdw, Gd^Fmf, Gd^Fdw, Hhd^Fdf, Gll^Fmf, Rb^Fdw, Hhd^Fdf, Gd^Fdw, Hhd^Fdw, Rb^Fdw, Rb^Fmf, Gd^Fmf, Gll^Fmf, Gs
Md, Hhd, Gll, Gll, Rb, Gll, Gll, Rb, Gd, Re, Hhd, Hhd, Hhd, Gd, Gd, Gd^Fdw, Gd, Re, Gd, Gll, Gd^Fp, Gg^Fdw, Gll, Gll, Gll, Gll^Fdw, Re^Fdw, Rb^Fmw, Gll^Fmf, Re^Fmf, Gll^Fmf, Re^Edt, Rb^Fdw, Gd^Edb, Gll
Md, Hhd, Hhd, Rb, Gll, Re, Rb, Gd, Rb, Gd, Gd^Fdw, Gll, Gd, Gd, Gd, Rb, Gd, Gll, Gd^Fdw, Gll, Rb, Gll, Gll, Rb^Fdw, Rb, Gll, Gd, Rb^Fmf, Gll, Gll^Edt, Rb, Gll, Rb^Fdw, Rb^Fdw, Re
Hhd, Hhd, Gd, Hhd, Gd, Rb, Rb, Re, Gll, Rb, Gll, Gd, Hhd, Rb, Rb, Gd, Rb, Gll, Gll, Gd, Gd, Gd, Gd^Fmf, Gll, Gll, Gd, Gd^Fmf, Hhd^Fmf, Gll^Fdw, Rb, Gd, Rb^Fdf, Gll, Re, Re
Hhd, Gll, Hhd, Gd, Rb, Rb, Gd, Hhd, Gd, Gll, Gll, Gll, Gll, Gd, Gll, Gd, Gd, Rb, Gd, Gd, Hhd, Hhd, Gd, Gd, Gll^Edb, Gd, Gd^Edt, Gll^Edt, Gd^Fdw, Gd, Re^Edt, Gll, Rb, Gll^Edb, Gll
Hhd, Md, Gll, Gd, Re, Gd, Gd, Gll, Gll, Rb, Gd, Gd, Gd, Re, Rb, Gd, Hhd, Gll, Gd, Hhd, Gd, Hhd, Gll, Rb^Fmf, Gd, Re^Edt, Gll, Gll^Fdw, Gd^Vdr, Re^Es, Rb^Es, Re^Es, Rb, Gll, Rb
Hhd, Hhd, Re, Gll, Gd, Re, Gd, Gll, Rb, Gll, Re, Gll, Rb^Edb, Gll, Hhd, Gd, Rb, Gd, Gd, Gd^Fmf, Gd, Hhd, Gd, Gd, Gll, Re^Fdw, Gll, Rb, Gd, Gd, Re^Fmf, Rb^Fdw, Gll, Gll, Gll
Hhd, Re, Hhd, Hhd^Vhhr, Re, Gd, Gll, Gd, Gll, Gd, Md, Md, Md, Re, Gll, Gd, Gd, Re, Gll, Gd, Gd, Rb, Gll, Re, Re, Gll^Fdw, Rb, Gd, Gd, Gd, Gd, Gd, Gd, Gll^Fdw, Gs
Md, Hhd, Gd, Hhd, Gll, Gd, Gll, Hhd, Gll, Gll, Rb, Md, Hhd, Hhd, Gd, Gd, Gd, Gd, Gll, Gll, Gd^Fdw, Gd, Gd, Gd, Gd, Gd, Gd, Gd^Fdw, Gd^Fdw, Re, Gd, Gd, Gd, Gll, Gll
Md, Hhd, Gd, Gd, Gll, Re, Gll, Gd, Rb, Gd, Gd, Hhd, Gd, Hhd, Gd, Rb, Rb, Gll, Re^Vl, Gll, Gd, Re, Gll, Gd, Gd, Re, Gd, Gd, Gll, Gd, Re, Rb, Rb, Gd, Gd
Md, Hhd, Hhd, Gd, Re, Gd, Gd, Gd, Gd, Gll, Rb, Gll, Gll, Rb, Rb, Gd, Re, Gll, Re, Gd, Gll, Re, Gll, Gll, Gll, Re^Edb, Re, Gll, Gll, Gd, Gll, Gll^Edb, Gll, Gll, Gd
Dd^Es, Re, Re, Re, Re, Gll, Gll, Re, Gd, Gll, Gd, Gll, Gd, Gll, Gll, Gd, Gll, Gd, Gll, Gll, Gll, Gd, Rb, Gll, Gd, Gd, Gll, Gll, Gll, Gd, Gd, Re, Gll^Edb, Gd, Gs
Hhd, Ds^Es, Dd^Es, Hhd, Re, Re, Gll, Re, Re, Gs, Gd, Re, Gll, Re, Gll, Re, Gd, Gll^Edb, Gd, Re, Gd, Gd, Rb, Gd, Gs, Gll, Gll, Gs, Gs, Gll, Gs, Gd, Gs, Gs, Wwf
Rb^Es, Dd^Es, Ds^Edb, Hhd, Gll^Fdf, Re, Rb, Gd, Gs, Gd, Gll, Gll, Ds^Edb, Gs, Ds, Gll, Gll, Gd, Gg, Gd, Gs, Gs, Gs, Gs, Ds^Edb, Gll^Esd, Ds^Edb, Gd^Esd, Wwrg^Ewf, Ds^Edb, Ds^Bw|r, Gs, Wwf^Es, Wwrg^Ewf, Ds
Hhd, Ds^Esd, Re, Dd^Esd, Ds, Re^Esd, Ds, Rd, Ds, Gd, Ds, Ds, Ds^Es, Sm^Es, Ds, Gll^Bw|r, Ds^Es, Ds, Ds^Es, Ds, Sm^Ewf, Ds, Wwf^Es, Ds, Ds^Es, Ds, Ds^Es, Ds^Edb, Ds, Ds, Ds^Bw|r, Ds, Ds^Edb, Ds^Es, Gd
Md, Hhd, Md, Md, Re, Gd, Re, Ds^Edb, Re, Ds^Es, Ds^Es, Wwf^Ewf, Gs^Esd, Ds^Es, Gll, Dd^Bw|, Ds^Edb, Sm^Ewf, Gs, Ds^Edb, Gs, Gll^Esd, Gs, Ds^Edb, Gd, Gs, Gll, Re, Gll, Gd, Rb, Rb, Re, Re, Gs
Md, Hhd, Gll^Vhhr, Gd, Gll, Re, Cer^Edb, Re, Re, Ds, Sm^Es, Ds, Gd, Gll, Gll^Edb, Gll, Gll, Gs, Gll, Gd, Rb, Gd, Gd, Re, Gd, Gs, Rb, Gd, Cte, Chr^Ebn, Cvr, Rb, Re, Gd, Gd
Hhd, Hhd, Gd, Gd, Gll, Cer^Eb, 3 Ke, Cer^Edb, Gd, Ds^Es, Sm^Bw/, Re^Bw\r, Gs, Gd, Gll, Gd, Gd, Gd, Re, Gd, Gd, Gd, Gll, Gll^Edb, Rb, Gd, Gll^Edt, Gll, Cvr^Edt, 2 Khr, Chr^Dr, Gd, Gd, Rb, Gs
Md, Hhd, Hhd, Re, Re, Gll^Edb, Gll^Edb, Cer^Ebn, Gg, Wwf^Bw/r, Ds^Edb, Gg, Gs, Gd, Gd, Gd, Rb, Gd^Edb, Gd, Gd, Gll, Gd, Rb, Gll, Gll, Re, Gll, Gll, Gd, Cte^Ebn, Gs, Gll, Gll, Gd, Gll
Md, Hhd, Hhd, Gd, Gd, Gd^Edb, Gll, Re, Gd, Sm^Ewf, Ds^Es, Gll, Gd, Gll, Gd, Re, Gd, Gll, Gd, Re, Gd, Gd, Gd, Gd, Gll, Gd, Gd, Gd, Gll^Vhhr, Gll, Gll, Gll^Edb, Gd, Gd, Gll
Hhd, Md, Hhd, Hhd, Hhd, Hhd, Gg, Gg, Gg, Sm, Gg, Gg, Gg, Gd, Gd, Gd, Gd, Gd, Gd, Gd, Gd, Gd, Gs, Gd, Gs, Gd, Gs, Gs, Gs, Gll, Gs, Gd, Gd, Gll, Gg
