Xu, Uu, Uu, Uue, Rb, Uu, Xu, Uue, Xu, Uu, Uhe, Uu, Uue^Es, Uh, Uh, Uue, Xu, Xu, Md^Xm, Ms^Xm, Ms^Xm, Ms^Xm, Ms^Xm, Ms^Xm, Ms^Xm, Ms^Xm, Hhd, Ms^Xm, Md, Md, Md, Md, Mm, Ms^Xm, Ms^Xm
Uh, Xu, Uhe, Xu, Uh, Uue^Vu, Rb^Edt, Uue^Es, Uue^Es, Xu, Xu, Uu^Es, Uhe, Uu^Es, Xu, Uhe, Uhe, Xu, Md^Xm, Md, Md^Xm, Hhd, Ms^Xm, Md, Md, Ms, Md, Md, Md, Md, Mm^Vl, Hhd^Fdw, Mm, Mm, Mm
Uhe, Uh, Xu, Xu, Re^Edb, Rb, Ce, Rb, Re^Edt, Gll, Re, Uue, Uue, Xu, Re^Es, Rb^Vu, Xu, Xu, Md^Xm, Ms^Xm, Ms, Md, Ms, Ms, Md, Md, Md, Md, Hhd^Em, Hhd^Fdf, Hhd^Fdw, Hhd^Fdw, Hhd^Fdw, Hhd^Fdf, Mm
Xue, Uue^Es, Uue^Es, Re, Gd^Es, Cer, 1 Ker, Cer^Es, Rb, Re, Re^Edt, Re, Re^Edb, Rb, Rb, Uue, Xu, Ms^Xm, Ms, Md, Ms, Md, Md, Md, Hhd^Fdf, Md, Hhd^Fdw, Hh^Fmf, Gd^Fmf, Hhd^Fmf, Rb^Fdw, Gd^Fmf, Gll^Fdw, Rb^Fmf, Gll^Fmf
Uh, Xue, Xue, Gll, Re, Re^Es, Cer^Es, Cer^Es, Gll, Rb^Edt, Re, Rb^Edt, Re, Re, Rb, Gd, Gd, Md, Md, Gll^Fdf, Md, Hhd, Hhd^Fmf, Hhd^Vl, Hhd^Em, Hhd^Fmf, Hhd^Fdw, Gd^Fdw, Rb^Fmw, Rb^Fdw, Hhd^Fp, Rb^Fdw, Gd^Fdf, Re^Fdw, Gg^Fmf
Uh, Uue, Uh^Vu, Uue, Gd^Edt, Re, Rb, Gd^Edt, Rd^Edt, Rb, Re, Re^Edt, Gll, Re, Rb, Rb, Gll^Fdw, Hhd, Hhd^Fmf, Hhd, Hhd^Fmf, Hhd^Fdw, Hhd^Fdw, Hhd^Fdw, Gll^Fmf, Hhd^Fdf, Gd^Fmw, Re^Fdw, Re^Edt, Hhd^Fmf, Hhd^Fdw, Gll^Fdw, Hhd^Fdw, Rb^Fdw, Gll^Fmf
Uu, Uue, Uue, Gll, Re, Re, Rb^Edt, Re, Rb^Edt, Re^Edt, Re, Re, Rb^Edt, Gd, Rb^Fdw, Rb^Edb, Gll^Fdw, Hhd^Fdw, Rb^Fmw, Re^Fdw, Rb^Fdw, Gll^Fmf, Rb^Fdw, Gll^Fdf, Hhd^Fdw, Gll^Fdf, Rb^Fdw, Gll^Fdf, Rb^Fdw, Gll^Fdf, Gg^Fmf, Gd^Fdw, Rb^Fdw, Rb^Fdw, Gll
Xu, Uue, Gll^Es, Xu, Re, Re, Re, Rb, Rb, Re, Gll, Re, Rb, Gll, Re^Fdw, Rb^Fdw, Gd^Fmf, Re^Fdw, Rb^Fdw, Gd^Fdw, Hhd^Fdw, Gd^Fmw, Rb^Edt, Re^Fdw, Re^Fdw, Gd^Fdf, Hhd^Fdw, Rb^Fmf, Rb^Fmf, Rb^Fmf, Rb^Fdw, Re^Fdw, Gll^Fmf, Hhd^Fdw, Gg^Fmf
Ms^Xm, Gll^Es, Hhd^Es, Gd^Es, Hhd, Re, Rb, Re, Rb, Re, Gd, Gll, Rb^Vhr, Rb, Gll, Re^Fdw, Rb^Edt, Rb^Fdw, Gll^Fmf, Rb^Fdf, Re^Fdw, Gd^Fdw, Hhd^Fdw, Gd^Fmf, Rb^Fdf, Re^Fdw, Rb^Fdw, Hhd^Fdf, Gd^Fdw, Gll^Fdf, Rb^Fdw, Gll^Fmf, Rb^Fmf, Gd^Fdf, Gd
Mm, Mm, Mm^Edb, Hhd^Edb, Hhd^Edb, Hhd^Edb, Gd, Re, Rb, Re^Edb, Rb, Hhd, Rb, Gd, Rb, Rb, Gll^Fdw, Rb^Edt, Gd^Edt, Rb^Fdf, Re^Fdw, Rb^Fmf, Hhd^Fdw, Re^Fmf, Rb^Fdf, Rb^Fmf, Rb^Fmw, Hhd^Fdw, Gll^Fdf, Re^Fdw, Gd^Fmf, Re^Edt, Rb^Fdw, Rb^Fdw, Re
Mm, Mm, Mm, Hhd, Gd, Rb, Gll, Hhd, Rb^Edt, Rb^Edt, Rb, Rb, Rb, Gll, Re, Gd, Gll, Gs^Fmf, Gll^Fdf, Gd^Fdw, Rb^Fdw, Gll^Fdw, Re^Fmf, Re^Fmf, Rb^Fmf, Rb^Fmw, Re^Fdw, Hhd^Fdw, Hhd^Fdf, Hhd^Fdw, Rb^Fdw, Rb^Fmf, Re^Fdw, Re^Fdw, Re
Ms^Xm, Ms^Xm, Hhd, Hhd^Edb, Hhd, Gll, Re, Rb, Rb, Rb, Rb, Rb, Gll^Fdw, Rb^Edb, Rb, Re, Re, Gll, Re, Gd^Fmw, Gd^Fmf, Hhd^Fdw, Rb^Fdw, Rb^Fdw, Gd^Vc, Re^Fdw, Rb^Fmf, Rb^Fdw, Rb^Fdw, Gs^Fdf, Rb^Fdw, Re^Fdw, Re^Fdw, Re^Fdw, Rb
Mm, Mm, Hhd, Hhd, Hhd, Rb, Rb, Hhd, Rb, Rb, Rb^Edt, Rb, Rb, Rb, Gll^Edb, Gd, Hhd, Re^Fmf, Re, Gd^Edt, Gll^Em, Gd^Fmf, Gd^Fdw, Rb^Fmf, Rb^Fmf, Re^Fdw, Rb^Edt, Re^Fdw, Rb^Fdw, Rb^Fmf, Re^Fdf, Rb^Edt, Re^Fdw, Gll^Fmf, Re
Mm, Mm, Mm, Hhd, Rb, Rb, Hhd^Edt, Hhd, Rb, Rb, Rb, Gll, Gd^Fdw, Rb, Rb, Hhd, Rb, Re, Rb, Gll, Gs^Fdw, Gd^Fmf, Rb^Fdw, Rb^Fdw, Re^Fdw, Re^Fdw, Rb^Fdw, Gll^Fmf, Hhd^Fmf, Re^Fmf, Gll^Fdw, Re^Fdw, Gd^Fdw, Rb^Em, Gll
Hhd, Hhd, Gd, Hhd^Vct, Gll^Edb, Hhd, Hhd, Hhd, Gll, Rb, Hhd, Rb, Rb, Gll, Rb, Rb, Rb, Rb^Edb, Rb, Gd, Gd, Rb^Fdw, Gd^Fmf, Gd^Fdw, Hhd^Fdf, Gll^Fmf, Rb^Fdw, Hhd^Fdf, Rb^Fdw, Hhd^Fdw, Rb^Fdw, Rb^Fmf, Rb^Fmf, Gll^Fmf, Gs
Md, Hhd, Rb, Rb^Edt, Rb, Rb, Rb, Rb, Gd^Edt, Re, Hhd, Hhd^Edt, Hhd, Gd^Edt, Re, Gd^Fdw, Re^Edt, Rb, Gd, Rb, Gd^Fp, Gg^Fdw, Rb^Edb, Rb, Rb, Gll^Fdw, Re^Fdw, Rb^Fmw, Re^Fmf, Re^Fmf, Gll^Fmf, Re^Edt, Rb^Fdw, Re^Edb, Gll
Md, Hhd, Hhd, Rb, Gll, Re, Rb, Gd, Rb, Gd, Gd^Fdw, Gll, Re, Re, Re^Edb, Rb, Re, Gll, Gd^Fdw, Rb, Rb^Edb, Rb, Rb, Rb^Fdw, Rb^Edb, Rb, Rb, Rb^Fmf, Gll, Gll^Edt, Rb, Re, Rb^Fdw, Rb^Fdw, Re
Hhd, Hhd, Rb, Hhd^Edt, Rb, Rb, Rb, Re, Re, Rb, Re, Re, Hhd, Rb, Rb^Edb, Re^Edb, Rb^Edt, Gll, Gll, Rb, Rb^Edb, Rb^Edb, Gd^Fmf, Rb, Rb, Rb, Gd^Fmf, Hhd^Fmf, Rb^Fdw, Rb, Rb^Edb, Rb^Fdf, Re, Re, Re
Hhd, Gll, Hhd, Rb, Rb, Rb, Gd, Hhd, Gd, Re, Re, Re, Re, Gd, Gll^Edt, Re, Re, Rb, Rb, Rb^Edb, Hhd, Hhd, Re, Re, Gll^Edb, Rb, Re^Edt, Re^Edt, Gd^Fdw, Rb, Re^Edt, Re, Re, Gll^Edb, Re
Hhd, Md, Gll, Rb, Re, Gd, Gd, Rb, Rb, Rb, Gd, Gd, Gd, Re^Edt, Rb, Re, Hhd, Gll^Edt, Rb, Hhd, Rb, Hhd, Gll, Rb^Fmf, Rb, Re^Edt, Gll, Re^Fdw, Gd^Vdr, Re^Es, Rb^Es, Re^Es, Re, Re, Rb
Hhd, Hhd, Re, Gll, Gd, Re^Edt, Gd, Rb, Rb^Edt, Rb^Edt, Re, Rb, Rb^Edb, Gll, Hhd, Re, Rb, Rb, Rb, Gd^Fmf, Rb, Hhd, Rb, Rb, Gll, Re^Fdw, Gll, Rb^Edb, Rb^Edt, Rb, Re^Fmf, Rb^Fdw, Re, Re, Re
Hhd, Re, Hhd, Hhd^Vhhr, Re, Gd, Rb, Gd, Re, Gd, Md, Md, Md, Re, Gll, Re, Re, Re, Rb, Rb, Rb^Edb, Rb, Gll, Re^Edt, Re, Gll^Fdw, Rb, Rb, Rb, Rb^Edt, Rb^Edt, Rb, Rb, Gll^Fdw, Gs
Md, Hhd, Gd, Hhd, Gll, Gd, Rb, Hhd, Re, Re, Rb, Md, Hhd^Edt, Hhd^Edt, Re, Re^Edt, Rb^Eff, Rb^Eff, Gll^Eff, Rb, Gd^Fdw, Rb^Edt, Rb^Edt, Rb, Rb^Edb, Rb^Edb, Rb, Gd^Fdw, Gd^Fdw, Re, Rb^Edt, Rb, Rb, Gll^Edb, Gll
Md, Hhd, Gd, Gd, Gll, Re, Rb, Re, Rb, Rb, Rb, Hhd, Gd, Hhd, Re, Rb^Eff, Rb^Eff, Re, Re^Vl, Rb, Gd^Eff, Re, Re, Rb, Rb, Re, Rb, Rb, Re, Rb, Re, Rb, Rb^Edb, Rb^Edb, Rb
Md, Hhd, Hhd, Gd, Re, Re, Re^Edt, Re^Edt, Re, Gll, Rb, Re, Re, Rb, Rb, Re, Re, Gll^Eff, Re^Eff, Gd^Eff, Rb, Re, Re, Re, Re^Edt, Re^Edb, Re, Re^Edt, Re, Rb^Edb, Gll, Gll^Edb, Re, Re^Edb, Rb
Dd^Es, Re, Re, Re, Re, Rb, Rb, Re, Re, Gll, Rb, Re, Gd^Edt, Re^Edt, Re^Edb, Re, Gll, Gd, Rb, Rb, Rb^Edb, Rb^Edt, Rb, Re, Gd, Gd^Edb, Re^Edb, Re^Edb, Re, Rb, Rb^Edt, Re, Gll^Edb, Rb^Edb, Gs
Hhd, Ds^Es, Dd^Es, Hhd, Re, Re, Rb, Re, Re, Gs^Edt, Rb, Re, Gll, Re, Re, Re, Rb, Gll^Edb, Rb, Re, Rb, Rb, Rb, Gd^Edb, Gs, Re, Re, Gs, Gs, Re, Gs, Rb^Eb, Gs, Gs, Wwf
Rb^Es, Dd^Es, Ds^Edb, Hhd, Gll^Fdf, Re, Rb, Gd, Gs, Rb, Gll, Gll, Ds^Edb, Gs, Ds^Edb, Re, Re^Eb, Rb, Gg, Rb, Gs, Gs, Gs, Gs, Ds^Edb, Gll^Esd, Ds^Edb, Gd^Esd, Wwrg^Ewf, Ds^Edb, Ds^Bw|r, Khr, Wwf^Es, Wwrg^Ewf, Ds
Hhd, Ds^Esd, Re, Dd^Esd, Ds, Re^Esd, Ds, Rd, Ds, Rb, Ds^Edb, Ds^Edb, Ds^Edt, Sm^Es, Ds^Edb, Gll^Bw|r, Ds^Edt, Ds^Edt, Ds^Es, Ds, Sm^Ewf, Ds, Wwf^Es, Ds, Ds^Es, Ds^Dr, Ds^Es, Ds^Edb, Ds^Edt, Ds^Edt, Ds^Bw|r, Ds^Edt, Ds^Edb, Ds^Es, Gd
Md, Hhd, Md, Md, Re^Edt, Gd, Re, Ds^Edb, Re, Ds^Es, Ds^Edt, Wwf^Ewf, Gs^Esd, Ds^Edt, Gll, Dd^Bw|, Ds^Edb, Sm^Ewf, Gs, Ds^Edb, Gs, Gll^Esd, Gs, Ds^Edb, Rp^Edb, Chr, Cvr^Edb, Re^Dr, Rp^Edb, Gd^Eb, Rp, Khr, Re^Dr, Cvr^Dr, Gs
Md, Hhd, Gll^Vhhr, Re, Rb^Edt, Re, Cer^Edb, Re, Re, Ds^Edt, Sm^Es, Ds, Rb, Gll^Edb, Gll^Edb, Gll^Edb, Gll^Eb, Gs, Gll, Rb, Rb^Edb, Rb, Rb, Re, Rp^Edb, Rp^Edb, Rb^Edb, Rp, Cte^Dr, Chr^Ebn, Cvr^Edb, Rb^Edb, Rp^Edb, Rp^Edb, Re
Hhd, Hhd, Re^Edt, Re^Edt, Gll, Cer^Eb, 3 Ker, Cer^Edb, Gd^Eb, Ds^Es, Sm^Bw/, Re^Bw\r, Gs, Rb^Edb, Gll, Rb, Rb, Rb, Re^Edb, Rb^Edb, Rb^Edb, Rb^Edb, Re, Re^Edb, Khr^Edb, Gd^Eb, Rp^Edt, Rp^Edb, Cvr^Edt, 2 Khr, Rp^Dr, Rp^Edb, Cvr^Edb, Rb^Edb, Cvr
Md, Hhd, Hhd, Re, Re, Gll^Edb, Gll^Edb, Cer^Edt, Gg, Wwf^Bw/r, Ds^Edb, Gg^Eb, Gs, Rb, Rb^Edb, Rb^Edb, Rb^Edb, Gd^Edb, Rb, Rb, Gll, Rb, Rp^Edb, Rp^Edb, Gll^Edb, Re^Edb, Cvr^Edb, Rp^Edt, Rp^Edt, Cte^Ebn, Rp^Edb, Rp, Rp^Eb, Rp, Re
Md, Hhd, Hhd, Rb, Rb, Gd^Edb, Gll, Re, Gd, Sm^Ewf, Ds^Es, Gll^Edt, Rb, Gll^Edb, Rb^Edb, Re, Rb^Edb, Gll, Rb, Rb, Rb, Rb, Rb^Edb, Rb^Edb, Ker, Rp^Edb, Rp, Rp^Dr, Rp^Vhhr, Rp^Edb, Rp, Ker^Edb, Gd^Es, Khr, Re
Hhd, Md, Hhd, Hhd, Hhd, Hhd, Gg, Gg, Gg, Sm, Gg, Gg, Gg, Rb, Rb, Rb, Rb, Rb, Rb, Rb, Rb, Rb, Gs, Rb, Gs, Gd, Gs, Gs, Gs, Gll^Eb, Gs, Gd, Gd, Re, Gg
