Xu, Uu, Uu, Uue, Rb, Uu, Xu, Uue, Xu, Uu, Uhe, Uu, Uue^Es, Uh, Uh, Uue, Xu, Xu, Md^Xm, Ms^Xm, Ms^Xm, Ms^Xm, Ms^Xm, Ms^Xm, Ms^Xm, Ms^Xm, Hhd, Ms^Xm, Md, Md, Md, Md, Mm, Ms^Xm, Ms^Xm
Uh, Xu, Uhe, Xu, Uh, Uue^Vu, Gll, Uue^Es, Uue^Es, Xu, Xu, Uu^Es, Uhe, Uu^Es, Xu, Uhe, Uhe, Xu, Md^Xm, Md, Md^Xm, Hhd, Ms^Xm, Md, Md, Ms, Md, Md, Md, Md, Mm^Vl, Hhd^Fdf, Mm, Mm, Mm
Uhe, Uh, Xu, Xu, Re, Gd, Ce, Gd, Re, Gll, Gd, Uue, Uue, Xu, Re^Es, Rb^Vu, Xu, Xu, Md^Xm, Ms^Xm, Ms, Md, Ms, Ms, Md, Md, Md, Md, Hhd^Em, Hhd^Fdf, Hhd^Fdw, Hhd^Fdf, Hhd^Fdw, Hhd^Fdf, Mm
Xue, Uue^Es, Uue^Es, Gll, Gd^Es, Cer, 1 Ker, Cer^Es, Re, Gd, Rb, Gd, Gd, Gll, Gll, Uue, Xu, Ms^Xm, Ms, Md, Ms, Md, Md, Md, Hhd^Fdf, Md, Hhd^Fdw, Hh^Fp, Gg^Fmf, Hhd^Fms, Gg^Fp, Gg^Fmf, Gll^Fp, Gg^Fmf, Gll^Fmf
Uh, Xue, Xue, Gll, Gd, Gd^Es, Cer^Es, Cer^Es, Gll, Gd, Gd, Gll, Gd, Gd, Gll, Gd, Gd, Md, Md, Gll^Fdf, Md, Hhd, Hhd^Fmf, Hhd^Vl, Hhd^Em, Hhd^Fmf, Hhd^Fdw, Gll^Fms, Gll^Fmw, Gll^Fp, Hhd^Fp, Gll^Fmf, Gs^Fmw, Gll^Fdf, Gg^Fp
Uh, Uue, Uh^Vu, Uue, Gd, Gd, Gll, Gd, Rd, Rb, Gll, Gd, Gll, Gd, Gll, Rb, Gll, Hhd, Hhd^Fmf, Hhd, Hhd^Fmf, Hhd^Fp, Hhd^Fp, Hhd^Fp, Gll^Fmf, Hhd^Fms, Gg^Fmw, Gll^Fp, Gll^Fdw, Hh^Fms, Hh^Fds, Gll^Fmf, Gll^Fms, Gll^Fmf, Gll^Fp
Uu, Uue, Uue, Gll, Gd, Gs, Gd, Gll, Rb, Re, Gll, Gd, Rb, Gd, Gll, Gll, Gll, Hhd, Gll^Fmw, Gg^Fms, Gll^Fmf, Gll^Fmf, Gll^Fp, Gg^Fms, Gd^Fmf, Gll^Fdf, Gll^Fms, Gll^Fms, Gd^Fdf, Gll^Fp, Gg^Fmf, Gd^Fp, Gll^Fmf, Gll^Fmw, Gg
Xu, Uue, Gll^Es, Xu, Gll, Gll, Gll, Gd, Gll, Gs, Re, Gll, Gd, Gll, Gd, Gd, Gd^Fmf, Gll, Gll, Gs^Fms, Gll^Fms, Gd^Fmw, Gd^Fmf, Gg^Fp, Gd^Fp, Gll^Fp, Gll^Fmf, Gll^Fmf, Gll^Fmf, Gd^Fmw, Gll^Fmf, Gd^Fmw, Gg^Fmw, Gg^Fmw, Gg^Fmf
Ms^Xm, Gll^Es, Hhd^Es, Gd^Es, Hhd, Gll, Gs, Gll, Rb, Gll, Gd, Gll, Gd^Vht, Rb, Gll, Gs, Gll, Gll, Gll^Fms, Gll^Fmf, Gs^Fmf, Gd^Fmf, Gd^Fdw, Gd^Fds, Gll^Fdf, Re^Fdw, Gd^Fms, Gd^Fms, Gd^Fms, Gd^Fp, Gll^Fms, Gll^Fmf, Gll^Fms, Gs^Fp, Gg
Mm, Mm, Mm, Hhd, Hhd, Hhd, Gd, Gll, Gs, Re, Gll, Hhd, Gd, Gd, Gs, Gll, Gll, Gs, Gs, Gll^Fmw, Gll^Fds, Gll^Fp, Gg^Fms, Gd^Fms, Gs^Fmw, Gll^Fms, Gll^Fmw, Re^Fdw, Gd^Fp, Re^Fdw, Gd^Fmf, Gs, Gll^Fms, Gll^Fmf, Gg
Mm, Mm, Mm, Hhd, Gd, Rb, Gll, Hhd, Gd, Gd, Gll, Gd, Gd, Gs, Gd, Gs, Gll, Gs^Fms, Gll^Fms, Gll^Fmw, Gd^Fp, Gll^Fmw, Gll^Fmf, Gll^Fmf, Gll^Fms, Gll^Fmw, Gd^Fp, Gd^Fds, Gll^Fms, Gll^Fp, Gll^Fp, Gll^Fp, Gll^Fp, Gll^Fms, Gg
Ms^Xm, Ms^Xm, Hhd, Hhd, Hhd, Gll, Gd, Gd, Gd, Gg, Gd, Gd, Gs, Gs, Rb, Gll, Gll, Gll, Gs, Gll^Fmw, Gs^Fmf, Gll^Fmf, Gd^Fmf, Gll^Fp, Gd^Vc, Gs^Fds, Gll^Fmf, Gd^Fms, Gll^Fmw, Gs^Fms, Re^Fdw, Gd^Em, Gd^Fp, Gll^Fmf, Gll
Mm, Mm, Hhd, Hhd, Hhd, Gs, Gs, Hhd, Gs, Gd, Gd, Gd, Gd, Gd, Gll, Gd, Hhd, Gll^Fp, Gs, Gll, Gll^Em, Gs^Fmf, Gd^Fms, Gll^Fms, Gll^Fds, Re^Fdw, Gs^Fds, Gll^Fmf, Gll^Fmf, Gll^Fms, Gll^Fp, Gd, Gd^Fms, Gg^Fms, Gll
Mm, Mm, Mm, Hhd, Gs, Gs, Hhd, Hhd, Gd, Rb, Gd, Gll, Gd, Gs, Gd, Hhd, Gd, Gd, Gd, Gs, Gs^Fms, Gs^Fms, Gs^Fmf, Re^Fdw, Gll^Fmf, Gll^Fms, Gll^Fmf, Gll^Fmw, Gd^Fmf, Gg^Fmw, Gd^Fms, Gll^Fmf, Gd^Fp, Gll^Em, Gll
Hhd, Hhd, Gd, Hhd^Vo, Gs, Hhd, Hhd, Hhd, Gs, Gd, Gs, Gs, Gd, Gll, Re, Gd, Rb, Gs, Gd, Gs, Gd, Gll^Fmf, Gg^Fmf, Gd^Fp, Gg^Fms, Gll^Fmf, Gll^Fms, Gd^Fms, Gd^Fp, Gll^Fmf, Gd^Fms, Gg^Fms, Gd^Fmf, Gd^Fmf, Gs
Md, Hhd, Gs, Gs, Gll, Gs, Gll, Gd, Gd, Gs, Gd, Gd, Gd, Gd, Gll, Gs, Gs, Gs, Gd, Gll, Gll^Fp, Gg^Fdw, Gs, Gll, Gll, Gll^Fdw, Gll^Fms, Gll^Fmw, Gg^Fms, Gs^Fmf, Gg^Fp, Gd, Gg^Fms, Gd, Gs
Md, Hhd, Hhd, Gll, Gll, Gll, Gll, Gs, Gs, Gs, Gg, Gll, Gd, Gs, Gs, Gs, Gs, Gs, Gd, Gll, Gll, Gll, Gs, Rb, Gll, Gll, Gg, Gll^Fmf, Gg, Gs, Gll, Gd, Gg^Fms, Gg^Fms, Gs
Hhd, Hhd, Gd, Hhd, Gd, Gll, Gll, Gd, Gll, Gd, Gd, Gd, Gd, Gd, Gd, Gd, Gd, Gll, Gg, Gs, Gd, Gg, Gg^Fmf, Gs, Gg, Gll, Gd^Fmf, Gd^Fmf, Gll, Gll, Gs, Gg^Fmf, Gs, Gd, Gs
Hhd, Gs, Hhd, Gd, Gd, Gll, Gs, Hhd, Gd, Gs, Gs, Gs, Gll, Gs, Gll, Gs, Gs, Gd, Gd, Gd, Hhd, Hhd, Gs, Gs, Gs, Gs, Gll, Gll, Gs, Gs, Gs, Gd, Gs, Gs, Gs
Hhd, Md, Gll, Gd, Gll, Gd, Gll, Gll, Gll, Gll, Gs, Gd, Gll, Gs, Gll, Gs, Hhd, Gs, Gd, Hhd, Gd, Hhd, Gll, Gd^Fmf, Gs, Gs, Gs, Gs, Gg^Vo, Gll, Gll, Gs, Gd, Gs, Gs
Hhd, Hhd, Re, Gll, Gd, Gd, Gd, Gll, Gs, Gll, Gd, Gs, Gll, Gll, Hhd, Gd, Gd, Gd, Gs, Gs^Fmf, Gg, Hhd, Gg, Gg, Gll, Gs, Gs, Gs, Gs, Gs, Gll^Fmf, Gs, Gs, Gs, Gs
Hhd, Re, Hhd, Hhd^Vhs, Gd, Gs, Gs, Gd, Gs, Gd, Md, Md, Md, Gll, Gll, Gd, Gg, Gll, Gll, Gs, Gs, Gg, Rb, Gg, Gd, Gs, Gs, Gs, Gd, Gs, Gs, Gd, Gs, Gs, Gs
Md, Hhd, Gd, Hhd, Gd, Gs, Gs, Gd, Gd, Gs, Rb, Md, Gs, Gll, Gll, Gd, Gd, Gll, Gll, Gll, Gd, Gll, Gs, Gg, Gd, Gs, Gd, Gs, Gs, Gs, Gll, Gs, Gd, Gd, Gs
Md, Hhd, Gd, Gd, Gd, Gd, Gll, Gs, Gll, Gd, Gll, Gs, Gs, Gs, Gd, Rb, Rb, Gll, Gg^Vl, Gll, Gd, Gg, Gd, Gs, Gs, Gs, Gs, Gll, Gd, Gs, Gll, Gs, Gs, Gs, Gs
Md, Hhd, Hhd, Gd, Gs, Gll, Gs, Gd, Gg, Gll, Rb, Rb, Gd, Rb, Gd, Gd, Gd, Gll, Gd, Gs, Gs, Gd, Gg, Gs, Gg, Gll, Gs, Gll, Gs, Gs, Gs, Gs, Gs, Gs, Gs
Dd^Es, Re, Re, Re, Gs, Gs, Rb, Gll, Gll, Gd, Gll, Gs, Gg, Gd, Rb, Gd, Gll, Gg, Gg, Gg, Gll, Gg, Gll, Gll, Gll, Gs, Gs, Gs, Gs, Gd, Gs, Gs, Gs, Gs, Gs
Hhd, Ds^Es, Dd^Es, Hhd, Gd, Gd, Gd, Gd, Gg, Gg, Gd, Gs, Gs, Gs, Gs, Gs, Gs, Gll, Gll, Gg, Gg, Gll, Gd, Gg, Gg, Gg, Gll, Gs, Gll, Gll, Gs, Gs, Gs, Gs, Wwf
Rb^Es, Dd^Es, Ds^Esd, Hhd, Gs, Gd, Rb, Gd, Gg, Gd, Gs, Gs, Ds, Rb, Ds, Gs, Gs, Gg, Gg, Gd, Gg, Gg, Gg, Gg, Ds, Gll^Esd, Ds, Gg^Esd, Wwrg^Es, Ds, Ds^Bw|r, Gs, Wwf^Es, Wwrg^Es, Ds
Hhd, Ds^Esd, Re, Dd^Esd, Ds, Re^Esd, Ds, Rd, Ds, Gd, Ds, Ds, Ds^Es, Wwf^Es, Ds, Gs^Bw|r, Ds^Es, Ds, Ds^Es, Ds, Sm^Es, Ds, Wwf^Es, Ds, Ds^Es, Ds, Ds^Es, Ds, Ds, Ds, Ds^Bw|r, Ds, Ds, Ds^Es, Gg
Md, Hhd, Md, Md, Gd, Gd, Gd, Ds, Gs, Ds^Es, Ds^Es, Wwf^Es, Gg^Esd, Ds^Es, Gg, Dd^Bw|, Ds, Sm^Es, Gs, Ds, Gg, Gll^Esd, Gg, Ds, Gg, Gs, Gs, Gll, Gs, Gs, Gg, Gs, Gs, Gg, Gg
Md, Hhd, Gg^Vo, Gs, Gs, Gs, Cer, Gs, Gs, Ds, Sm^Es, Ds, Gd, Gg, Gd, Gg, Gs, Gs, Gg, Gd, Gg, Gg, Gg, Gs, Gd, Gg, Gg, Gs, Cte, Chr, Cvr, Gd, Gs, Gg, Gg
Hhd, Hhd, Gs, Gd, Gs, Cer, 3 Ke, Cer, Gd, Ds^Es, Wwf^Bw/, Re^Bw\r, Gg, Gd, Gg, Gd, Gd, Gg, Gd, Gd, Gg, Gll, Gs, Gg, Gg, Gll, Gg, Gg, Cvr, 2 Khr, Chr, Gg, Gll, Gs, Gs
Md, Hhd, Hhd, Gd, Gs, Gg, Gg, Cer, Gg, Wwf^Bw/r, Ds, Gg, Gg, Gg, Gd, Gg, Gg, Gd, Gd, Gd, Gs, Gd, Gg, Gg, Gg, Gs, Gg, Gd, Gd, Cte, Gg, Gs, Gg, Gg, Gll
Md, Hhd, Hhd, Gs, Gd, Gs, Gs, Gs, Gd, Wwf^Es, Ds^Es, Gg, Gg, Gd, Gd, Gd, Gg, Gs, Gd, Gs, Gd, Gg, Gd, Gg, Gd, Gg, Gg, Gg, Gg^Vhhr, Gg, Gs, Gs, Gs, Gll, Gll
Hhd, Md, Hhd, Hhd, Hhd, Hhd, Gg, Gg, Gg, Wwf, Gg, Gg, Gg, Gg, Gg, Gg, Gg, Gg, Gg, Gd, Gg, Gg, Gg, Gg, Gg, Gg, Gg, Gg, Gg, Gg, Gg, Gll, Gg, Gs, Gg
